CREATE USER: CREATE USER '<user>'@'<IP>' IDENTIFIED BY '<password>';

GIVE ALL PERMISSIONS: GRANT ALL PRIVILEGES ON *.* TO '<user>'@'<IP>' WITH GRANT OPTION;

FLUSH PRIVILEGES: flush privileges;

CHANGE PASSWORD: ALTER USER 'root'@'localhost' IDENTIFIED BY 'MyN3wP4ssw0rd';
		 flush privileges;

RESTART MYSQL: sudo service mysql restart

MYSQL STATUS: sudo service mysql status

USE MYSQL: sudo mysql -u <user> -p;

SHOW DATABASES: show databases;

CREATE DATABASE: create database [databaseName];

USE DATABASE: use [databaseName];

CREATE TABLE: create table [tableName] (		//table
		<name> INT, 				//columns
		<name> varchar(maxCharacter)		//columns
		<name> BIGINT				//columns
		<name> ...  				//columns
		);

SHOW TABLES: show tables; 

DESCRIBE THE TABLE: describe [tableName]; 

INSERT VALUES: INSERT INTO [tableName] (<column>, <column1>, <column2>) VALUES (<value>, <value1>, <value2>);

SEE ROWS: select * from [tableName]; 			// * => all
	  select <column> from [tableName]; 

FILTER (look up) IN A ROW: select * from [tableName]/<column> where <column1> = "<value>";
			   select * from [tableName]/<column> where <column1> = "<value>" or <column> = "<value>";
			   select * from [tableName]/<column> where not <column1> = "<value>";

UPDATE ROWS: update [tableName] set <columns> = <updatedName/int> where <column1> = <notUpdatedRow>;

ADD A COLUMN: alter table [tableName] add [columnName] <type (ex: boolean, int)>; 

DELETE ROW: delete from [tableName] where <name>=[value]; 

DELETE A TABLE: drop table [tableName];

DELETE A DATABASE: drop database [databaseName];
